"filename", "language", "TypeScript", "SCSS", "JavaScript", "JSON", "comment", "blank", "total"
"c:\Users\Appbird\Documents\Project\Web\KirbySpeedScoreRecorders\src\scss\_common.scss", "SCSS", 0, 21, 0, 0, 0, 6, 27
"c:\Users\Appbird\Documents\Project\Web\KirbySpeedScoreRecorders\src\scss\common.scss", "SCSS", 0, 2, 0, 0, 4, 1, 7
"c:\Users\Appbird\Documents\Project\Web\KirbySpeedScoreRecorders\src\scss\compile.js", "JavaScript", 0, 0, 12, 0, 0, 0, 12
"c:\Users\Appbird\Documents\Project\Web\KirbySpeedScoreRecorders\src\scss\foundation\body.scss", "SCSS", 0, 6, 0, 0, 0, 0, 6
"c:\Users\Appbird\Documents\Project\Web\KirbySpeedScoreRecorders\src\scss\foundation\hr.scss", "SCSS", 0, 12, 0, 0, 0, 0, 12
"c:\Users\Appbird\Documents\Project\Web\KirbySpeedScoreRecorders\src\scss\layout\header.scss", "SCSS", 0, 10, 0, 0, 0, 4, 14
"c:\Users\Appbird\Documents\Project\Web\KirbySpeedScoreRecorders\src\scss\layout\main.scss", "SCSS", 0, 19, 0, 0, 0, 3, 22
"c:\Users\Appbird\Documents\Project\Web\KirbySpeedScoreRecorders\src\scss\layout\scrollBar.scss", "SCSS", 0, 16, 0, 0, 0, 2, 18
"c:\Users\Appbird\Documents\Project\Web\KirbySpeedScoreRecorders\src\scss\object\component\iconWithDescription.scss", "SCSS", 0, 6, 0, 0, 0, 0, 6
"c:\Users\Appbird\Documents\Project\Web\KirbySpeedScoreRecorders\src\scss\object\component\moviePlaceHolder.scss", "SCSS", 0, 11, 0, 0, 0, 1, 12
"c:\Users\Appbird\Documents\Project\Web\KirbySpeedScoreRecorders\src\scss\object\component\recordCard.scss", "SCSS", 0, 9, 0, 0, 0, 2, 11
"c:\Users\Appbird\Documents\Project\Web\KirbySpeedScoreRecorders\src\scss\object\component\recordCardsGroup.scss", "SCSS", 0, 3, 0, 0, 0, 0, 3
"c:\Users\Appbird\Documents\Project\Web\KirbySpeedScoreRecorders\src\scss\object\component\runnerNote.scss", "SCSS", 0, 13, 0, 0, 0, 4, 17
"c:\Users\Appbird\Documents\Project\Web\KirbySpeedScoreRecorders\src\scss\object\component\stateInfo.scss", "SCSS", 0, 8, 0, 0, 0, 0, 8
"c:\Users\Appbird\Documents\Project\Web\KirbySpeedScoreRecorders\src\scss\object\component\tags.scss", "SCSS", 0, 29, 0, 0, 0, 4, 33
"c:\Users\Appbird\Documents\Project\Web\KirbySpeedScoreRecorders\src\scss\object\component\title.scss", "SCSS", 0, 11, 0, 0, 0, 2, 13
"c:\Users\Appbird\Documents\Project\Web\KirbySpeedScoreRecorders\src\scss\object\utility\biggerChara.scss", "SCSS", 0, 17, 0, 0, 0, 0, 17
"c:\Users\Appbird\Documents\Project\Web\KirbySpeedScoreRecorders\src\scss\object\utility\fontChanger.scss", "SCSS", 0, 3, 0, 0, 0, 0, 3
"c:\Users\Appbird\Documents\Project\Web\KirbySpeedScoreRecorders\src\scss\object\utility\space.scss", "SCSS", 0, 16, 0, 0, 0, 0, 16
"c:\Users\Appbird\Documents\Project\Web\KirbySpeedScoreRecorders\src\scss\object\utility\underline.scss", "SCSS", 0, 3, 0, 0, 0, 1, 4
"c:\Users\Appbird\Documents\Project\Web\KirbySpeedScoreRecorders\src\scss\object\utility\unused.scss", "SCSS", 0, 3, 0, 0, 0, 0, 3
"c:\Users\Appbird\Documents\Project\Web\KirbySpeedScoreRecorders\src\scss\object\utility\width.scss", "SCSS", 0, 5, 0, 0, 0, 0, 5
"c:\Users\Appbird\Documents\Project\Web\KirbySpeedScoreRecorders\src\ts\client\App.ts", "TypeScript", 131, 0, 0, 0, 2, 31, 164
"c:\Users\Appbird\Documents\Project\Web\KirbySpeedScoreRecorders\src\ts\client\exampleInputData.json", "JSON", 0, 0, 0, 40, 0, 3, 43
"c:\Users\Appbird\Documents\Project\Web\KirbySpeedScoreRecorders\src\ts\client\index.ts", "TypeScript", 23, 0, 0, 0, 39, 2, 64
"c:\Users\Appbird\Documents\Project\Web\KirbySpeedScoreRecorders\src\ts\client\interface\AppInterfaces.ts", "TypeScript", 12, 0, 0, 0, 0, 1, 13
"c:\Users\Appbird\Documents\Project\Web\KirbySpeedScoreRecorders\src\ts\client\interface\PageStates.ts", "TypeScript", 8, 0, 0, 0, 1, 2, 11
"c:\Users\Appbird\Documents\Project\Web\KirbySpeedScoreRecorders\src\ts\client\test\exampleData.json", "JSON", 0, 0, 0, 50, 0, 0, 50
"c:\Users\Appbird\Documents\Project\Web\KirbySpeedScoreRecorders\src\ts\client\utility\aboutElement.ts", "TypeScript", 6, 0, 0, 0, 0, 1, 7
"c:\Users\Appbird\Documents\Project\Web\KirbySpeedScoreRecorders\src\ts\client\view\IView.ts", "TypeScript", 3, 0, 0, 0, 0, 0, 3
"c:\Users\Appbird\Documents\Project\Web\KirbySpeedScoreRecorders\src\ts\client\view\RecordDetailView.ts", "TypeScript", 58, 0, 0, 0, 1, 16, 75
"c:\Users\Appbird\Documents\Project\Web\KirbySpeedScoreRecorders\src\ts\client\view\RecordsGroupView.ts", "TypeScript", 70, 0, 0, 0, 2, 4, 76
"c:\Users\Appbird\Documents\Project\Web\KirbySpeedScoreRecorders\src\ts\client\view\StateInfoView.ts", "TypeScript", 17, 0, 0, 0, 0, 1, 18
"c:\Users\Appbird\Documents\Project\Web\KirbySpeedScoreRecorders\src\ts\client\view\TagsView.ts", "TypeScript", 104, 0, 0, 0, 0, 7, 111
"c:\Users\Appbird\Documents\Project\Web\KirbySpeedScoreRecorders\src\ts\client\view\widgets.ts", "TypeScript", 46, 0, 0, 0, 1, 3, 50
"c:\Users\Appbird\Documents\Project\Web\KirbySpeedScoreRecorders\src\ts\indexOnServer.ts", "TypeScript", 25, 0, 0, 0, 0, 4, 29
"c:\Users\Appbird\Documents\Project\Web\KirbySpeedScoreRecorders\src\ts\server\firebaseAdmin.ts", "TypeScript", 9, 0, 0, 0, 0, 2, 11
"c:\Users\Appbird\Documents\Project\Web\KirbySpeedScoreRecorders\src\ts\server\firestore\RecordDataBase.ts", "TypeScript", 116, 0, 0, 0, 7, 20, 143
"c:\Users\Appbird\Documents\Project\Web\KirbySpeedScoreRecorders\src\ts\server\function\apiDefinition.ts", "TypeScript", 12, 0, 0, 0, 0, 2, 14
"c:\Users\Appbird\Documents\Project\Web\KirbySpeedScoreRecorders\src\ts\server\function\record\detail.ts", "TypeScript", 10, 0, 0, 0, 0, 1, 11
"c:\Users\Appbird\Documents\Project\Web\KirbySpeedScoreRecorders\src\ts\server\function\record\search.ts", "TypeScript", 49, 0, 0, 0, 3, 7, 59
"c:\Users\Appbird\Documents\Project\Web\KirbySpeedScoreRecorders\src\ts\server\recordConverter\ControllerOfTableForResolvingID.ts", "TypeScript", 144, 0, 0, 0, 4, 20, 168
"c:\Users\Appbird\Documents\Project\Web\KirbySpeedScoreRecorders\src\ts\server\test\RecordDataBase.test.ts", "TypeScript", 60, 0, 0, 0, 12, 3, 75
"c:\Users\Appbird\Documents\Project\Web\KirbySpeedScoreRecorders\src\ts\server\test\RecordDataBaseForFireBase.test.ts", "TypeScript", 84, 0, 0, 0, 13, 3, 100
"c:\Users\Appbird\Documents\Project\Web\KirbySpeedScoreRecorders\src\ts\server\test\addExampleDataToFirestore.ts", "TypeScript", 20, 0, 0, 0, 1, 2, 23
"c:\Users\Appbird\Documents\Project\Web\KirbySpeedScoreRecorders\src\ts\server\test\exampleRecords.ts", "TypeScript", 39, 0, 0, 0, 1, 4, 44
"c:\Users\Appbird\Documents\Project\Web\KirbySpeedScoreRecorders\src\ts\server\test\exampledata.ts", "TypeScript", 42, 0, 0, 0, 0, 7, 49
"c:\Users\Appbird\Documents\Project\Web\KirbySpeedScoreRecorders\src\ts\server\tmpDataBase\RecordDataBase.ts", "TypeScript", 97, 0, 0, 0, 4, 23, 124
"c:\Users\Appbird\Documents\Project\Web\KirbySpeedScoreRecorders\src\ts\server\type\IGameSystemInfo.ts", "TypeScript", 15, 0, 0, 0, 0, 3, 18
"c:\Users\Appbird\Documents\Project\Web\KirbySpeedScoreRecorders\src\ts\server\type\IItemOfResolveTableToName.ts", "TypeScript", 10, 0, 0, 0, 0, 1, 11
"c:\Users\Appbird\Documents\Project\Web\KirbySpeedScoreRecorders\src\ts\server\type\IRecordDataBase.ts", "TypeScript", 6, 0, 0, 0, 0, 3, 9
"c:\Users\Appbird\Documents\Project\Web\KirbySpeedScoreRecorders\src\ts\server\type\InterfaceOfRecordDatabase.ts", "TypeScript", 29, 0, 0, 0, 1, 9, 39
"c:\Users\Appbird\Documents\Project\Web\KirbySpeedScoreRecorders\src\ts\server\type\LanguageInApplication.ts", "TypeScript", 1, 0, 0, 0, 1, 1, 3
"c:\Users\Appbird\Documents\Project\Web\KirbySpeedScoreRecorders\src\ts\server\type\OrderOfRecordArray.ts", "TypeScript", 1, 0, 0, 0, 1, 1, 3
"c:\Users\Appbird\Documents\Project\Web\KirbySpeedScoreRecorders\src\ts\server\type\UniqueResolveTableToGameSystem.ts", "TypeScript", 20, 0, 0, 0, 3, 3, 26
"c:\Users\Appbird\Documents\Project\Web\KirbySpeedScoreRecorders\src\ts\setting\settings.ts", "TypeScript", 7, 0, 0, 0, 0, 2, 9
"c:\Users\Appbird\Documents\Project\Web\KirbySpeedScoreRecorders\src\ts\type\foundation\IGameSystemEnvironment.ts", "TypeScript", 15, 0, 0, 0, 1, 0, 16
"c:\Users\Appbird\Documents\Project\Web\KirbySpeedScoreRecorders\src\ts\type\foundation\IRegulation.ts", "TypeScript", 16, 0, 0, 0, 0, 1, 17
"c:\Users\Appbird\Documents\Project\Web\KirbySpeedScoreRecorders\src\ts\type\foundation\ITargetInformation.ts", "TypeScript", 5, 0, 0, 0, 0, 2, 7
"c:\Users\Appbird\Documents\Project\Web\KirbySpeedScoreRecorders\src\ts\type\record\IRecord.ts", "TypeScript", 36, 0, 0, 0, 4, 3, 43
"c:\Users\Appbird\Documents\Project\Web\KirbySpeedScoreRecorders\src\ts\type\record\IRecordGroupResolved.ts", "TypeScript", 8, 0, 0, 0, 0, 2, 10
"c:\Users\Appbird\Documents\Project\Web\KirbySpeedScoreRecorders\src\ts\type\record\IRunner.ts", "TypeScript", 14, 0, 0, 0, 0, 1, 15
"c:\Users\Appbird\Documents\Project\Web\KirbySpeedScoreRecorders\src\ts\type\transmission\record\IReceivedData_recordDetail.ts", "TypeScript", 28, 0, 0, 0, 0, 2, 30
"c:\Users\Appbird\Documents\Project\Web\KirbySpeedScoreRecorders\src\ts\type\transmission\record\IReceivedData_recordSearch.ts", "TypeScript", 46, 0, 0, 0, 2, 5, 53
"c:\Users\Appbird\Documents\Project\Web\KirbySpeedScoreRecorders\src\ts\type\transmission\transmissionBase.ts", "TypeScript", 6, 0, 0, 0, 0, 1, 7
"c:\Users\Appbird\Documents\Project\Web\KirbySpeedScoreRecorders\src\ts\utility\InputCheckerUtility.ts", "TypeScript", 43, 0, 0, 0, 1, 2, 46
"c:\Users\Appbird\Documents\Project\Web\KirbySpeedScoreRecorders\src\ts\utility\ViewUtility.ts", "TypeScript", 45, 0, 0, 0, 0, 2, 47
"c:\Users\Appbird\Documents\Project\Web\KirbySpeedScoreRecorders\src\ts\utility\arrayUtility.ts", "TypeScript", 9, 0, 0, 0, 0, 0, 9
"c:\Users\Appbird\Documents\Project\Web\KirbySpeedScoreRecorders\src\ts\utility\errorUtility.ts", "TypeScript", 0, 0, 0, 0, 0, 1, 1
"c:\Users\Appbird\Documents\Project\Web\KirbySpeedScoreRecorders\src\ts\utility\inputCheckerUtility.test.ts", "TypeScript", 77, 0, 0, 0, 0, 2, 79
"c:\Users\Appbird\Documents\Project\Web\KirbySpeedScoreRecorders\src\ts\utility\rankUtility.ts", "TypeScript", 11, 0, 0, 0, 0, 2, 13
"c:\Users\Appbird\Documents\Project\Web\KirbySpeedScoreRecorders\src\ts\utility\timeUtility.ts", "TypeScript", 14, 0, 0, 0, 0, 0, 14
"c:\Users\Appbird\Documents\Project\Web\KirbySpeedScoreRecorders\src\ts\utility\undefinedChecker.ts", "TypeScript", 4, 0, 0, 0, 0, 0, 4
"Total", "-", 1651, 223, 12, 90, 109, 248, 2333